[skdecide.domains]
CostDeterministicGymDomain=skdecide.hub.domain.gym:CostDeterministicGymDomain[domains]
DeterministicGymDomain=skdecide.hub.domain.gym:DeterministicGymDomain[domains]
FlightPlanningDomain=skdecide.hub.domain.flight_planning:FlightPlanningDomain[domains]
GymDomain=skdecide.hub.domain.gym:GymDomain[domains]
GymPlanningDomain=skdecide.hub.domain.gym:GymPlanningDomain[domains]
GymWidthDomain=skdecide.hub.domain.gym:GymWidthDomain[domains]
MRCPSP=skdecide.hub.domain.rcpsp:MRCPSP[domains]
MRCPSPCalendar=skdecide.hub.domain.rcpsp:MRCPSPCalendar[domains]
MSRCPSP=skdecide.hub.domain.rcpsp:MSRCPSP[domains]
MSRCPSPCalendar=skdecide.hub.domain.rcpsp:MSRCPSPCalendar[domains]
MasterMind=skdecide.hub.domain.mastermind:MasterMind[domains]
Maze=skdecide.hub.domain.maze:Maze[domains]
RCPSP=skdecide.hub.domain.rcpsp:RCPSP[domains]
RCPSPCalendar=skdecide.hub.domain.rcpsp:RCPSPCalendar[domains]
RockPaperScissors=skdecide.hub.domain.rock_paper_scissors:RockPaperScissors[domains]
SMRCPSPCalendar=skdecide.hub.domain.rcpsp:SMRCPSPCalendar[domains]
SimpleGridWorld=skdecide.hub.domain.simple_grid_world:SimpleGridWorld[domains]
Stochastic_RCPSP=skdecide.hub.domain.rcpsp:Stochastic_RCPSP[domains]
UPDomain=skdecide.hub.domain.up:UPDomain[domains]

[skdecide.solvers]
AOstar=skdecide.hub.solver.aostar:AOstar[solvers]
Astar=skdecide.hub.solver.astar:Astar[solvers]
AugmentedRandomSearch=skdecide.hub.solver.ars:AugmentedRandomSearch[solvers]
BFWS=skdecide.hub.solver.bfws:BFWS[solvers]
CGP=skdecide.hub.solver.cgp:CGP[solvers]
DOSolver=skdecide.hub.solver.do_solver:DOSolver[solvers]
GPHH=skdecide.hub.solver.do_solver:GPHH[solvers]
ILAOstar=skdecide.hub.solver.ilaostar:ILAOstar[solvers]
IW=skdecide.hub.solver.iw:IW[solvers]
LRTAstar=skdecide.hub.solver.lrtastar:LRTAstar[solvers]
LRTDP=skdecide.hub.solver.lrtdp:LRTDP[solvers]
LazyAstar=skdecide.hub.solver.lazy_astar:LazyAstar[solvers]
MAHD=skdecide.hub.solver.mahd:MAHD[solvers]
MARTDP=skdecide.hub.solver.martdp:MARTDP[solvers]
MCTS=skdecide.hub.solver.mcts:MCTS[solvers]
MaxentIRL=skdecide.hub.solver.maxent_irl:MaxentIRL[solvers]
POMCP=skdecide.hub.solver.pomcp:POMCP[solvers]
PilePolicy=skdecide.hub.solver.pile_policy_scheduling:PilePolicy[solvers]
RIW=skdecide.hub.solver.riw:RIW[solvers]
RayRLlib=skdecide.hub.solver.ray_rllib:RayRLlib[solvers]
SimpleGreedy=skdecide.hub.solver.simple_greedy:SimpleGreedy[solvers]
StableBaseline=skdecide.hub.solver.stable_baselines:StableBaseline[solvers]
UCT=skdecide.hub.solver.mcts:UCT[solvers]
UPSolver=skdecide.hub.solver.up:UPSolver[solvers]

